1111111111111111111111111
10000000000C0000000000001
1000C01100000111100000001
1C00011000001100110000001
100011C011011001100000001
1001111111000011000000001
1P00000011001111110000E01
1111111111111111111111111