1111111111111111111111111111111111
1000000001111100000000000000000001
1000000000111110000000000000000001
1000000000000000000011111100C00001
1000P00000000000000000000000WC0001
1000000000000001111110000000C00001
1000000000000001111110000000000001
1000000000000000000000000000000001
1000000000000000000000000000000001
1000000000000000000000000000000001
10000000000000000000000000000000E1
1111111111111111111111111111111111
