1111111111111
100100000CC01
1000011111001
1P0011E010001
1111111111111